111111111111111111111111
1E00000C0000000000C00001
101110010001010101001001
1P0000000000000000000001
101011010010101010100101
101000C000C0000000000001
101111111111111111111111