1111111111111111111
1E000C000000C000001
1010111110101010101
1P00000000000000001
101110101011110101
100000C000C00000001
1111111111111111101
