1111111111111111111
1E000C000000C000001
1010111110101010101
1P00000000000000001
1011101010111101011
100000C000C00000001
1111111111111111101